1111111111111111111111111111111111111111111111111111
100000000000000C0010000000000000000000000000000000C1
1010010100100000101000000000000000000000000000000011
1010010010101010001000000000000000000000000000000011
1010010010101010001000000000000000000000000000000011
1010010010101010001000000000000000000000000000000011
1010010010101010001000000000000000000000000000000011
1010010010101010001000000000000000000000000000000011
1010010010101010001000000000000000000000000000000011
1010010010101010001000000000000000000000000000000011
1010010010101010001000000000000000000000000000000011
1010010010101010001000000000000000000000000000000011
1010010010101010001000000000000000000000000000000011
1010010010101010001000000000000000000000000000000011
1010010010101010001000000000000000000000000000000011
1010010010101010001000000000000000000000000000000011
1010010010101010001000000000000000000000000000000011
1010010010101010000000000000000000000000000000000011
1010010010101010001000000000000000000000000000000011
1E10010010101010001000000000000000000000000000000011
1P0000000C00C000001000000000000000000000000000000001
1111111111111111111111111111111111111111111111111111
